12:12
0  0   0   0 1 0  0 0 8 1 0  0
52 0   0   0 0 0  0 0 1 0 1  0
0 0   0   0 0 0  0 0 0 0 0  0
0 0   0   1 1 17 0 0 0 0 0  0
0 0   0   1 0 0  0 0  0 0 57 0
0 0   0   0 0 0  0 0  0 0 0 0
0 153 0   0 0 0  0 0  0 0 0 0
0 0 0   0 0 0 0  0  0 0 0 0
0 0 0   0 0 0 0  0  0 0 0 0
0 0 0 0 0 0 0 36 0 0 0 0
0 0 0 0 0 0 0 0 0 0 0 0
0 0 0 1 0 0 0 0 0 0 1 1
