12:12
0   0  0   0 1 0  0 0 0 1 8 0
0   89 0   0 0 0  0 0 1 0 1 0
0   0 0   0 0 0  0 0  0 0 0 0
0   0 0   1 1 17 0 0  0 0 0 0
0   0 0   1 0 0 0 0   0 0 0 0
0   0 0   0 0 0 0 0   0 0 0 0
0   0 0   0 0 0 0 0   0 0 0 0
0   0 0   0 0 0 0 0   0 0 0 0
0   0 0   0 0 0 0 0   0 0 0 0
0   0 185 0 0 0 0 17  0 0 0 0
0   0 0 0 0 0 0 0 100 0 0 0
68 0 0 1 0 0 0 0 0 0 1 1
